West Indies
    •    Brian Lara Stadium — San Fernando
    •    Daren Sammy Cricket Ground — Gros Islet
    •    Kensington Oval — Bridgetown
    •    Providence Stadium — Georgetown
    •    Queen’s Park Oval — Port of Spain
    •    Sabina Park — Kingston
    •    Sir Vivian Richards Stadium — St John’s
    •    Warner Park — Basseterre

Pakistan
    •    Gaddafi Stadium — Lahore
    •    Multan Cricket Stadium — Multan
    •    National Stadium — Karachi
    •    Rawalpindi Cricket Stadium — Rawalpindi

New Zealand
    •    Basin Reserve — Wellington
    •    Bay Oval — Mt Maunganui
    •    Eden Park — Auckland
    •    Hagley Oval — Christchurch
    •    McLean Park — Napier
    •    University of Otago Oval — Otago

India
    •    ACA Stadium — Guwahati
    •    ACA-VDCA Cricket Stadium — Visakhapatnam
    •    Arun Jaitley Cricket Stadium — New Delhi
    •    BRSABV Ekana Cricket Stadium — Lucknow
    •    Eden Gardens — Kolkata
    •    HPCA Stadium — Dharamshala
    •    MA Chidambaram Stadium — Chennai
    •    Mullanpur Stadium — Chandigarh
    •    Narendra Modi Stadium — Ahmedabad
    •    Rajiv Gandhi International Stadium — Hyderabad
    •    Sawai Mansingh Stadium — Jaipur
    •    Wankhede Stadium — Mumbai

England
    •    Edgbaston — Birmingham
    •    Emirates Old Trafford — Manchester
    •    Headingley — Leeds
    •    Kia Oval — London
    •    Lord’s — London
    •    Utilita Bowl — Southampton
    •    Sophia Gardens — Cardiff
    •    Trent Bridge — Nottingham
    •    1st Central County Ground — Hove
    •    Northampton County Ground — Northampton
    •    Taunton County Ground — Taunton 

Australia
    •    Adelaide Oval — Adelaide
    •    Bellerive Oval — Hobart
    •    The Gabba — Brisbane
    •    Melbourne Cricket Ground — Melbourne
    •    Perth Stadium — Perth
    •    Sydney Cricket Ground — Sydney
    •    Allan Border Field — Brisbane
    •    Cazalys Stadium — Cairns
    •    Coffs Harbour — Coffs Harbour
    •    Docklands Stadium — Melbourne
    •    GMHBA Stadium —Geelong
    •    Great Barrier Reef Arena — Brisbane
    •    Junction Oval — Melbourne
    •    Karen Rolton Oval — Adelaide 
